floral: (33)  ['abstract floral', 'abstract floral print', 'belted floral', 'belted floral print', 'chiffon floral', 'crochet floral', 'ditsy floral', 'ditsy floral print', 'embroidered floral', 'floral', 'floral flutter', 'floral knit', 'floral lace', 'floral lace mini', 'floral lace sheath', 'floral lace skater', 'floral maxi', 'floral mesh', 'floral midi', 'floral mini', 'floral paisley', 'floral pattern', 'floral peasant', 'floral pleated', 'floral print', 'floral print skater', 'floral print strapless', 'floral print surplice', 'floral shift', 'floral skater', 'floral surplice', 'floral textured', 'floral-embroidered']
graphic: (3)  ['graphic', 'graphic muscle', 'graphic racerback']
striped: (12)  ['back striped', 'boxy striped', 'classic striped', 'knit striped', 'nautical striped', 'neck striped', 'pinstriped', 'rugby striped', 'striped', 'striped trapeze', 'striped v-neck', 'varsity-striped']
embroidered: (13)  ['crochet embroidered', 'embroidered', 'embroidered fit', 'embroidered floral', 'embroidered gauze', 'embroidered gauze peasant', 'embroidered lace', 'embroidered maxi', 'embroidered mesh', 'embroidered peasant', 'embroidered shift', 'embroidered woven', 'floral-embroidered']
pleated: (8)  ['box-pleated', 'chiffon pleated', 'floral pleated', 'lace pleated', 'pintuck pleated', 'pleated', 'pleated skater', 'pleated woven']
solid: (1)  ['solid']
lattice: (1)  ['lattice']
print: (57)  ['abstract chevron print', 'abstract floral print', 'abstract geo print', 'abstract print', 'abstract printed', 'animal print', 'bandana print', 'baroque print', 'belted floral print', 'bird print', 'botanical print', 'brushstroke print', 'butterfly print', 'chevron print', 'daisy print', 'diamond print', 'ditsy floral print', 'elephant print', 'floral print', 'floral print skater', 'floral print strapless', 'floral print surplice', 'folk print', 'geo print', 'giraffe print', 'grid print', 'heart print', 'ikat print', 'kaleidoscope print', 'lace print', 'leaf print', 'leopard print', 'mandala print', 'marble print', 'medallion print', 'mixed print', 'mosaic print', 'ornate print', 'paisley print', 'palm print', 'print', 'print racerback', 'print satin', 'print scuba', 'print shift', 'print shirt', 'print skater', 'print smock', 'print smocked', 'print strapless', 'print strappy', 'print surplice', 'print tulip', 'print v-neck', 'print woven', 'printed', 'southwestern-print']
denim: (10)  ['bleached denim', 'classic denim', 'cuffed denim', 'denim', 'denim drawstring', 'denim pencil', 'denim shift', 'denim shirt', 'denim skater', 'denim utility']
chiffon: (13)  ['beaded chiffon', 'belted chiffon', 'chiffon', 'chiffon floral', 'chiffon lace', 'chiffon layered', 'chiffon maxi', 'chiffon paneled', 'chiffon pleated', 'chiffon shift', 'chiffon shirt', 'chiffon surplice', 'chiffon-paneled']
cotton: (5)  ['classic cotton', 'cotton', 'cotton drawstring', 'cotton knit', 'cotton-blend']
leather: (21)  ['faux leather', 'faux leather mini', 'faux leather moto', 'faux leather paneled', 'faux leather pencil', 'faux leather skater', 'faux leather varsity', 'faux leather-paneled', 'faux leather-trimmed', 'leather', 'leather mini', 'leather moto', 'leather paneled', 'leather pencil', 'leather peplum', 'leather quilted', 'leather skater', 'leather trimmed', 'leather varsity', 'leather-paneled', 'leather-trimmed']
knit: (34)  ['back knit', 'boxy knit', 'cable knit', 'cable-knit', 'chunky knit', 'classic knit', 'cotton knit', 'crochet knit', 'cropped knit', 'eyelash knit', 'floral knit', 'fuzzy knit', 'heathered knit', 'knit', 'knit lace', 'knit longline', 'knit maxi', 'knit mini', 'knit open', 'knit pencil', 'knit pocket', 'knit raglan', 'knit shawl', 'knit skater', 'knit stripe', 'knit striped', 'knit trapeze', 'knit v-neck', 'loose-knit', 'open-knit', 'rib-knit', 'ribbed-knit', 'slub-knit', 'stretch-knit']
mesh: (11)  ['crochet mesh', 'embroidered mesh', 'floral mesh', 'lace mesh', 'mesh', 'mesh overlay', 'mesh panel', 'mesh paneled', 'mesh racerback', 'mesh-paneled', 'mesh-trimmed']
fur: (2)  ['faux fur', 'fur']
lace: (38)  ['back lace', 'belted lace', 'boxy lace', 'chiffon lace', 'collar lace', 'crochet lace', 'crocheted lace', 'cutout lace', 'embroidered lace', 'eyelash lace', 'floral lace', 'floral lace mini', 'floral lace sheath', 'floral lace skater', 'knit lace', 'lace', 'lace layered', 'lace maxi', 'lace mesh', 'lace midi', 'lace mini', 'lace overlay', 'lace panel', 'lace paneled', 'lace pencil', 'lace peplum', 'lace pleated', 'lace print', 'lace sheath', 'lace sheer', 'lace shift', 'lace skater', 'lace sleeve', 'lace trim', 'lace-paneled', 'lace-trim', 'lace-trimmed', 'lace-up']
long-sleeve: (6)  ['knit longline', 'long sleeve', 'long-sleeve', 'long-sleeved', 'longline', 'longline shirt']
sleeveless: (1)  ['sleeveless']
crew-neck: (4)  ['classic crew', 'classic crew neck', 'crew', 'crew neck']
v-neck: (8)  ['classic v-neck', 'deep v-neck', 'fitted v-neck', 'heathered v-neck', 'knit v-neck', 'print v-neck', 'striped v-neck', 'v-neck']
turtle-neck: (1)  ['turtle-neck']
round-neck: (1)  ['round']
collar: (8)  ['arrow collar', 'beaded collar', 'collar', 'collar lace', 'collared', 'collarless', 'collarless faux', 'notched collar']
tie: (8)  ['bustier', 'cities', 'self-tie', 'tie-back', 'tie-dye', 'tie-front', 'tie-neck', 'tiered']
zip: (7)  ['zip', 'zip-front', 'zip-pocket', 'zip-up', 'zipped', 'zipper', 'zippered']
loose: (3)  ['relaxed', 'loose', 'loose-knit']
fit: (8)  ['classic fit', 'embroidered fit', 'eyelet fit', 'fit', 'fit flare', 'fit skinny', 'fitted', 'fitted v-neck']
skinny: (10)  ['classic skinny', 'distressed skinny', 'fit skinny', 'high-rise skinny', 'low-rise skinny', 'mid rise skinny', 'mid-rise skinny', 'rise skinny', 'skinny', 'skinny stretch']
retro: (1)  ['retro']
sporty: (1)  ['sporty']
